11111111111111111111111111111111111111111111111111111111111111111111111111111111
1                                                                              1
1                                                                             91
1                                                                          11111
1                                                                          11111
1                                                                        1111111
1                                                                        1111111
1                                                                      111111111
1                                                                      111111111
1                           111                                      11111111111
1                           111                                      11111111111
1                          11111                                   1111111111111
1                          11111                                   1111111111111
1i                        1111111                                111111111111111
111                       1111111                                111111111111111
1111                     111111111                             11111111111111111
11111                    111111111                             11111111111111111
111111          m       11111111111           n              1111111111111111111
1111111         m       11111111111           n              1111111111111111111
11111111        m      1111111111111          n            111111111111111111111
111111111       m      1111111111111          n            111111111111111111111
11111111111111111111111111111111111111111111111111111111111111111111111111111111
0
An SPACE cai thang ngu kia !!!
YAY!