11111111111111111111111111111111111111111111111111111111111111111111111111111111
11111111111113  3333333333333333333333333333333    333333113333   333   33333331
1333333333                                               13                    1
1              1111111111111111                 1        13             p      1
1   n       11 11111111111111111               11111     13             p      1
1   n      111 1111111111111111111             3111111   11j            p      1
1   n 11111111 1111111111111111111111          311111    11111  51  11  p      1
1   11       1 11111111111111111111111111111155111111  111111122112211511111   1
1  1         1 12111211121112212221111111111111111111   1111111111111          1
1            1 121112111211112121211113333333333333 11                         1
1111        31 12111121211111212121111              111111111111      1111111551
13          31 12221112111211212221111              333333333333    111111111111
1          111  1111111111111111111111                              113       31
1            1        122111122111111                            5  113       31
1  152222222213       122111122111111                            1  113       31
1   122222222113  3 3311112211111    o 141441  1 41                 113       31
1   122222222111111 1111111111111  111              141             113    9   1
11  122222222111111 1333333333333 1111                   1     5   1113 q  1   1
1   122222222111111k              1111                      1 11        q  3   1
1  m1222222221111114111111111111111111                                  q 3  l 1
1i 112222222211112222211111111111111113333333333333333333333333333   3  15111151
11111111111111111111111111111111111111111111111111111111111111111111111111111111
3
Now what? I have to climb this?
Phew!
Well, there's no way back.
Better watch my head.
Bloody spikes...



