11111111111111111111111111111111111111111111111111111111111111111111111111111111
1333333333333333333333331111113333333333333                        333        31
1i                      111111                               111          11 111
111                    1111111                              11111       1111 111
1 11                  11111111            1                111111111 1111111 111
1  11                111111111j           1               111111111111111111 111
1k  11             1111111111111          1              1111111111111111111 111
11   11            1111111111111   333   31 3           111111111111       n 111
11    111111444111111111111111111111111151151          1111111111111 1111111 111
111     1                11111111         11          11111111111111 11111122211
1111    1                   11111                   11111119         11111122211
11111   3                    11                511111111111111111111o11111111111
111111   m                                    1111111111111111111111 11111111111
1111111  m                                      11 11 11 11 11 11111 111     111
11111111 m                                      11 11 11 11 11 11111 11       11
111111111m                                                       111k11       11
1111111111                                                       1 8           1
11111111111                                151                                 1
11111111  111 11  1  11111  1 11111       11111                         11111  1
1111111    122122212211122221221112222221111111122122122122122122122122111111121
1111111 11 122122212211122221221112222211111111122122122122122122122122111111121
11111111111111111111111111111111111111111111111111111111111111111111111111111111
3
More climbing...
That was close!
What? The exit was right there!





