11111111111111111111111111111111111111111111111111111111111111111111111111111111
1     m                 333331119       333 33333  n                           1
1     m               1      3111                  n                          l1
1i    m     33 3      1      3111113       7   111111111     1111111       11111
1111111     11 11   111       3111111133    1111111111    1  3   333      1    1
1111111     11 11   111       3111111111  1111111111     11              11    1
1111111     11 111  111        333   111511   1111      1       11111          1
1111111     11 111  111                 11            11       11  33  1   8   1
1111111     1 j111  111                             11                 1111    1
1111111     1 11115 111             11111111  1111111        111               1
1111111     1 11111 111            1111  111                   111             1
1111111      o11111 111           1111    11                     111          51
1111111      o      111       1111111      1                       11        111
1111111     11111115111 1111                                k       11      1111
1111111    311111111111                      5   1          1        11    11111
1111111    311111111111222222222222222222222212221        1 12222222221122222221
11111115   311111111111222222222222222222222212221      1 1 12222222222112222221
11111111222211111221112222222222222222222222212221111 1 1 1 12222222222211222221
11111111222221122222122222222222222222211222212211111212121212222222222222222221
11111111222222122222222222222222222222111122112111111212121212222222222222222221
11111111222222222222222222222222222221111112111111111212121212222222222222222221
11111111111111111111111111111111111111111111111111111111111111111111111111111111
3
What is going on?
All this jumps are making me dizzy.
Another shiny thing up there...





