11111111111111111111111111111111111111111111111111111111111111111111111111111111
1 3333333333333333333333333333 1111             1111111111111111111111    111111
1                              1111  1111111111   11111111111111111111 11 111111
1                              1111       111111       111111111111    11 111111
1                              1111111111 111111111     11          11111   1111
1                              1111111111 1111111111221            11111111 1111
1                              33333 1111   1111111111111         111111111 1111
1         141     11133               11151     11111111111444444411111111   111
1        11 113  1111111               11111111       11111       1111111  11111
1i      11   11111111111                 m  111111111 11111221 12211111111 11111
1111 1  1     1111111111             711111 111111    11111221 12211111111  1111
1       1     1111111111              11111  11111 11111111111 111111111111 1111
122222221     11111111113       15    111111   111    1                       11
122222221  k  11111111111      111    1111111 1111111 1                       11
12222111111411111111111111   11133  311111111   11    1                  4444411
122211 33 1 1 333 1111111   1111    31111111111 11 1111                    n  11
11111     1 13   311111    11111222222111111111 11   11                    l  11
11        1 1     111    111111122222211111111  1111 11             9      1  11
1111   8               111111111222222222222211 11   11       111   11     1  11
1111                 11111111111222222222222211     1112222222111221111222212211
1          3  122211111111111111111111222222211 11111112222222111221111222212211
11111111111111111111111111111111111111111111111111111111111111111111111111111111
2
What the hack!
Easy...






