11111111111111111111111111111111111111111111111111111111111111111111111111111111
111 111111 11 11111111 111111111 11 1111 1  111 111 1111111111111111111111111111
1i11111 13 1111111 111 11 11 111  1  11  11111 111111 111111111  3 1111111111111
1 133 113   k11111  1   111   1   1  111  1111  1111 11 11111 1        111111111
1 1    1    111111      1           11      1 1111 111111111    111     11111111
1m         1 1  11                            111111 111 11  11111111   11111111
1m       111111 1                            11 1111111  11    111   3 3111 1111
11       111111111                               111 111111    11    1 1 1 1 111
1111    111111  111       111 1 11      p       1 111 111111  11            1111
11113    111 111 11      11 111111      p         1 111  111  11             111
11111       11111 1     111 33 1 111    p                  1   1            1111
111111       1  111 1111113    1  111   p                  11  1          111111
1111113           1     11     3  3 1 1 p                  q  11           11111
1111111           1111  11          31111                  q 111         1111111
1111111113          n   11              1       4j4        11111       oo   1111
1111111111          n 1111                                 11113       o       1
11111111111        1111111                       3        11113        o 7     1
11111111111       11111111  8   13 1444 1        1       11113    3    o       1
111111111115      11111111l 13  11 1    13   15         31111 13 11151 o      91
11111111111122222211111111111121112122221112111222221221111112112111122121122111
11111111111122222211111111111111111122111111111222211111111111111111122111112111
11111111111111111111111111111111111111111111111111111111111111111111111111111111
3
Finally! I dont have to climb!
...
I have to do this quickly.
IMPOSSIBRU!
... ... ...



