11111111111111111111111111111111111111111111111111111111111111111111111111111111
1       m   11111111111111111111111111111112222222222221111111111111111111111111
1i      1   11111111111111111111111111111111222222222211111111111111111111111111
111   1113 311111111111111111111111111111111122222222111111111111111111111111111
1113  111  111111              1111111111111111111111111111111111111111111111111
1111 1111   11111 11111111      111111111111111111111111111111111111111111111111
1111 11113  11111    11 11          1111111111111111111111111111111111         1
1111 111113 11111111 117111 44 111  11111111111111111111111111111111   111111  1
1111 111111 11111    11 1112222111  1111111111111111111111111111111  111111113 1
1111 11113  11111 11111 1112222111  11111111111111111111111111111   1111111111 1
1112221113  11111        1111111111  33331111111111111111  333333 11111111111  1
1122222113  11111111111  11111111111    31111111111111111         11111111111  1
1112221111  1111111111   111111111111     311111111111111 1111111111111111111  1
111111111  3111111133   5111111111111      311111111111  8  11111111116111111  1
111111111  31111113    11111111111111 1     11133  33311  1111111111166611111 31
111111111   111113    111111111111    122222111           1111111111666111111  1
11k  11113  11113    1111111111111 11111222111   1111111151111111111111111111  1
111  31111  1113    1111111111113   31111211     1111111111111111111111111111  1
1111  11113 113    111111111111113 3333111    1111111111111111111111111111111  1
1111  31111 11    1111116111111111 111111  1111111111116111111116161111661111  1
11111            11111666111111111     n  111111111116661111111166611166661119 1
11111111111111111111111111111111111111111111111111111111111111111111111111111111
1
Well, not exactly what I expected.
Again and again...






