11111111111111111111111111111111111111111111111111111111111111111111111111111111
1i                   31111111111111111111111144444444444444441111111144444441111
11111111111111111111 31111111111111444444444444444444444444444444441111111111111
133                  31   333333333        111111113      3111111114444444444441
1   111111111111111  31j1           3 3  3                 111111111111111111111
1  11111111111111111111111111111111111111111111111         111111111111111111111
1 111111111111111l      3111111111111111111111     1       111111111111111111111
1       4444441111111 3     31111111111111133      11111111111111111111111111111
121      44111111111111111         11111113    111111111111111111111111111111111
121      111111111        11111111 1111111        111111111111111111111111111111
11111111                   1111333 331111111151   11                        1111
111111        1111111111     33      1111111111  111                           1
1       1111111111111                 3              1111111111111113  3 3 111 1
1n1111111111111111111       311115111        1115111111111111111111111111111   1
14    11111111              311111111    11111111111114444444444441111   m     1
1444441111111                          1111111111111114444444444441111   m 11111
1444441111111                1111111151111111144444444444444444444441133 1111111
15444k11111       333333333111111111111111111144444444444444444444441111 13    1
11222122222222222211111111111111111111114444444222222222222222222244111      7 1
112222222222222221111111122222222111111111111112222222222222222222221       1  1
122222222222222222222222222222222222222222222222222222222222222222221   3   1 91
11111111111111111111111111111111111111111111111111111111111111111111111111111111
3
What the hell! I can't even!...
There must be something here.






