11111111111111111111111111111111111111111111111111111111111111111111111111111111
1                           11111111111111111111111111111111111111111111      11
1i             1111111111   111111111111111             111111111111111111111111
1111111111111111111111      1111111111111111111      111111      1111111111111 1
11                       111111      1111111111111                j 111111111111
11               11111111111      111111111111111111      71111411111111111111 1
11   11111111111111                        1111111                  1111111    1
11   1111111111             111111111111   3   3     111111             111111 1
113  1111111111       111111111              3       111111111111111111111111111
11   1111111111    111111111   mm 111111111111111111111    1111119             1
11   1111111111    1111111111114411111111111111111      111111111111111111     1
11  31111111111                         1111111111111            1111111       1
11  11111                                  1111111      111111            33   1
11   n                1111111111111111         111111111111      111111111111111
11  111111111111151   1111111111111111            111111                   11111
1122111111111111111   1111111111111111             11111                       1
1222221111111111111   1111111111111111          11111111                   11111
1111111111111111111   111 11   11111   3        11         1222211511111111111 1
1l                    111   11111111  11122222111          122221111       11111
111441111    8   1    11111111111111    1111111            1111111111111111111 1
1                   15111111111111111             111111111111111111111111111111
11111111111111111111111111111111111111111111111111111111111111111111111111111111
2
It will be much faster through here!
Ha! Nice try!






