11111111111111111111111111111111111111111111111111111111111111111111111111111111
1                                                                              1
1                                                                              1
1                                                                              1
1                                                                              1
1                                                                              1
1                                    o                                         1
1                                    o                                         1
1                                    o                                         1
1                                    o                                         1
1                                  1111   1111111                             91
1                                 11111   11111111                          1111
1                                111111   111111111                         1111
1       m              n        1111111   1111111111                       11111
1       m    1         n       11111111    jp      11                      11111
1       m   11         n      111111111   1111111  111                    111111
1i      m  111         n     1111111111   1111111  1111                   111111
11111111111111   11111111111111111111112221111111  11111                 1111111
1111111111111122211111111111111111111112221111111                        1111111
11111111111111222111111111111111111111122211111111111111111111111111111111111111
11111111111111222111111111111111111111122211111111111111111111111111111111111111
11111111111111111111111111111111111111111111111111111111111111111111111111111111
1
WOW! Lava! Better be careful!
That was hot!
There is something shining down there. But it's dangerous.
This must have a high value. Let's see if I can find more.