11111111111111111111111111111111111111111111111111111111111111111111111111111111
1                                                                              1
1                                                                    p         1
1                                                                    p        31
1       m           n                                                p        31
1       m           n                                                p        31
1       m           n                                          11111111111111 11
1i      m     333   n   3 3                                    11111111        1
1111111111111111111111111 111111111111111                    1111111111        1
1111111111111111111111111 1111          1                    1111111111        1
1111111111111111111111111 111      l    1                  111111111111        1
1111111111111111111111111 11      1111  1                  111111111111        1
1111111111111111111111111 11     11111  1                11111111111111  3333331
1111111111111111111111111 11    111111                   11111111111111  1111111
1111111111111111111111111 11   111111111               1111111111111111  1111111
1111111111111111111111111 11  1111111111               1111111111111111  1111111
1111111111111111111111111   o11111111111             111111111111111111  q     1
1111111111111111111111111111111111111111             111111111111111111  q     1
11111111111111111111111111111111111111111111111111221111111111111111111  q    91
11111111111111111111111111111111111111111111111111221111111111111111111111111111
11111111111111111111111111111111111111111111111111111111111111111111111111111111
11111111111111111111111111111111111111111111111111111111111111111111111111111111
1
Spikes? Seriously?
Now this is getting boring!
Great! One of those shiny things!
This is not gonna be easy!
Well, I guess I was wrong.



