11111111111111111111111111111111111111111111111111111111111111111111111111111111
1                                                                             31
1         m        n                                                        3 31
1         m        n                                                   112111 11
1         m        n                                                  3112111 11
1i        m   7    n                                                 11111111k11
1111111  11111 1111111 12211111111             o                    311111111 11
11111   111111 1111111 12211111111             o                   1111111111 11
11     1111111 1111111 11111111111             o                  31111111111 11
11    1111111111111111 11111111111             o                 111111111111 11
11 1111111111111111111 11111111111             1122221122222111                1
11     1111111111111  8  111111111 3 3 3 3 3  111222211222221111               1
11111   11111111111111 111111111111111111111111111111111111111111              1
111111   1111111111111 1111111111111111111111111111111111111111111             1
1111111   1111       1 11111111111111111111111111111111111111111111            1
11111111   111  1    1 111111111111111111111111111111111111111111111           1
111111111   11  11   1 1111111111111111111111111111111111111111111111          1
1111111111      111  1 11111111111111111111111111111111111111111111111        91
11111111111     1111  j111111111111111111111111111111111111111111111111111111111
11111111111111111111111111111111111111111111111111111111111111111111111111111111
11111111111111111111111111111111111111111111111111111111111111111111111111111111
11111111111111111111111111111111111111111111111111111111111111111111111111111111
2
A new friend? Cool!
Another shiny thing. But, is it wort
Are you kidding me!?





