11111111111111111111111111111111111111111111111111111111111111111111111111111111
1                                                                              1
1                                                                    o         1
1                 n     j                                            o         1
1                 n                                                  o         1
1                 n                                                  o         1
1                 n                                11111111111111111111111111  1
1   m         1111114447444111                     11111111111111111111111111  1
1   m         111111       111                   1111111111111111111111111111  1
1   m       11111111       111                   11111111111111111             1
1i  m       111111113333333111                 11111              p            1
111111444411111111111111111111                 11111              p 111111111111
111111    11111111111111111111               1111111              p 111111111111
111111222211111111111111111111     l         1111111              p            1
111111222211111111111111111111     1       111111111 k            p           91
111111111111111111111111111111     1       1111111111114444444444111111111111111
1111111111111111111111111111112222212222211111111111111          111111111111111
11111111111111111111111111111122222122222111111111111113333333333111111111111111
11111111111111111111111111111122222122222111111111111111111111111111111111111111
11111111111111111111111111111111111111111111111111111111111111111111111111111111
11111111111111111111111111111111111111111111111111111111111111111111111111111111
11111111111111111111111111111111111111111111111111111111111111111111111111111111
3
This doesn't look very solid.
What are you? A guardian?
Now this is getting easy!
Obviously...




