11111111111111111111111111111111111111111111111111111111111111111111111111111111
1                                    3333333333333333333333333333333333333333311
1                                                                    j        11
1                                    111111116666666666666666666666666666666  11
1      m           n                 111111111111111111111111111111111111111  11
1      m           n                             33            33333          11
1      m           n                                            p             11
1i     m           n   333               1111111111             p             11
111111111111666666666661111111                 3331             p             11
111111111111111111111111111111                    111444444411166665666666611111
111111111111111111111111111111                  o 111   8   11111111111111111111
1111111111111111111111111111111151111           o                              1
1111111111111111111111111111111111111           o                              1
1111111111111111111111111111111111111           o    33   33                  91
1111111111111111111111111111111111111111112222211 1111111111111111 1111111111111
1111111111111111111111111111111111111111112222211 33333333333 l  1 1111111111111
1111111111111111111111111111111111111111111111111             3  1 1111111111111
1111111111111111111111111111111111111111111111111 11166666666611 1 1111111111111
1111111111111111111111111111111111111111111111111 11111111111111 1 1111111111111
1111111111111111111111111111111111111111111111111 11111111111111 1 1111111111111
1111111111111111111111111111111111111111111111111111111111111111   1111111111111
11111111111111111111111111111111111111111111111111111111111111111151111111111111
2
Ice? Sweet!
Weeeeeee!
I would like to now which way is better...
Ha! Almost got me!




