11111111111111111111111111111111111111111111111111111111111111111111111111111111
1                                                1                             1
1                                           222221                             1
1i                                          221111                             1
11111111111                          m     l22                                 1
11111111111111                       m     122                           1111111
1111111111111111                     m      22                           1  k 31
11111111111111111                    m      22   9                  1    1  3  1
111111111111111111     111111111111111111111221111111111111111111        1111  1
111111111111111111      11111111111111111111221111111111111111111           1  1
1111111111111111111       111111111111111111221111111111111111111      1    1  1
1111111111111111111            1111111111111221111111111111111111           1  1
11111111111111111111                  j     22                              1  1
1111111111111111111111                1     22                              1  1
1111111111111111111111111                   22                                 1
1111111111111111111111111          1        22                          11111151
1111111111111111111111111       3122222222222222222222222221         15111111111
1111111111111111111111111       3111111111111111111111111111       1111111111111
1111111111111111111111111                                    3333  1111111111111
11111111111111111111111111122252116666666666666666666666666661111111111111111111
11111111111111111111111111122212111111111111111111111111111111111111111111111111
11111111111111111111111111111111111111111111111111111111111111111111111111111111
3
Better be careful with this one!







