11111111111111111111111111111111111111111111111111111111111111111111111111111111
1i    m                    333                                                31
1111111                                                                       31
1111111  111111111111                         1 11 1         314111           31
11      11111111111111                       11 11 1111     311 111 1          1
11         333 111111111            333     111 11 1  11    111 111 133        1
13                  11111111111111111111111 111  1 1     15 111 1114111        1
13 33           7    11111111                            11        n  151  3  j1
13 111                111111                                          111  11 11
13 333 111111111111     111                                                    1
11     3333111111111     1                                                     1
13         3111111111                                                          1
1                     1                                                        1
13l 3                 11111      8    1                                        1
11111                               1111                                       1
1    111  33         1             111 11                                      1
1       111111  1  1 1111111 1 11111    11        k                9           1
1                                          1   1  1  1 1   1   1   1           1
12222222222222222222222222222222222222222221222122121121222122212221222222222221
12222222222222222222222222222222222222122221222122121121122122212221222222222221
12222222222222112112122222221212222211112221222112121111122122212221222221122121
11111111111111111111111111111111111111111111111111111111111111111111111111111111
3
What a mess!
Weeeee!






